.......#.....................................................
.......#.....................................................
.......#............#########................................
.......#####........#............................#...........
....................#............................#...........
....................#............................#...........
....................#.............#######........#...........
........................................#........#...........
....###########.........................#........#...........
..............#.........................#........#...........
..............#..................................#...........
..............#........#.........................#...........
.......................#.....#####...............#...........
.......................#.....#...............................
.......................#.....#...............................
.......................#######...............................
.............................................................
.........................................######..............
.............................................................
.............................................................
.............................................................
.............................................................
.............................................................
.............................................................